,Entity's Name,LOC Count,Header Count,Annotation Count,Inner Entities Lines,Total,Entity Type
,/:org.dbunit.database.DatabaseConnection,95,7,0,0,102,CLASS
,/:org.dbunit.database.AmbiguousTableNameException,18,2,0,0,20,CLASS
,/:org.dbunit.database.statement.SimplePreparedStatement,47,8,0,0,55,CLASS
,/:org.dbunit.database.statement.AbstractStatementFactory,14,6,0,0,20,CLASS
,/:org.dbunit.database.statement.IPreparedBatchStatement,9,4,0,0,13,INTERFACE
,/:org.dbunit.database.statement.AutomaticPreparedBatchStatement,46,6,0,0,52,CLASS
,/:org.dbunit.database.statement.AbstractPreparedBatchStatement,15,6,0,0,21,CLASS
,/:org.dbunit.database.statement.SimpleStatement,36,7,0,0,43,CLASS
,/:org.dbunit.database.statement.IBatchStatement,7,2,0,0,9,INTERFACE
,/:org.dbunit.database.statement.AbstractBatchStatement,22,6,0,0,28,CLASS
,/:org.dbunit.database.statement.IStatementFactory,7,3,0,0,10,INTERFACE
,/:org.dbunit.database.statement.PreparedBatchStatement,44,8,0,0,52,CLASS
,/:org.dbunit.database.statement.BatchStatement,29,5,0,0,34,CLASS
,/:org.dbunit.database.statement.CompoundStatement,25,5,0,0,30,CLASS
,/:org.dbunit.database.statement.BatchStatementDecorator,56,10,0,0,66,CLASS
,/:org.dbunit.database.statement.PreparedStatementFactory,36,6,0,0,42,CLASS
,/:org.dbunit.database.statement.StatementFactory,23,5,0,0,28,CLASS
,/:org.dbunit.database.AbstractResultSetTable,97,10,0,0,107,CLASS
,/:org.dbunit.database.ResultSetTableMetaData,173,16,0,0,189,CLASS
,/:org.dbunit.database.PrimaryKeyFilter,278,24,0,120,422,CLASS
,/:org.dbunit.database.PrimaryKeyFilter$FilterIterator,35,0,0,0,35,INNER_CLASS
,/:org.dbunit.database.PrimaryKeyFilter$PkTableMap,85,0,0,0,85,INNER_CLASS
,/:org.dbunit.database.IDatabaseConnection,19,8,0,0,27,INTERFACE
,/:org.dbunit.database.DatabaseTableIterator,39,8,0,0,47,CLASS
,/:org.dbunit.database.DefaultMetadataHandler,94,7,0,0,101,CLASS
,/:org.dbunit.database.ForwardOnlyResultSetTableFactory,41,9,0,0,50,CLASS
,/:org.dbunit.database.DatabaseSequenceFilter,105,16,0,62,183,CLASS
,/:org.dbunit.database.DatabaseSequenceFilter$DependencyInfo,62,0,0,0,62,INNER_CLASS
,/:org.dbunit.database.ForwardOnlyResultSetTable,54,9,0,0,63,CLASS
,/:org.dbunit.database.CachedResultSetTableFactory,31,7,0,0,38,CLASS
,/:org.dbunit.database.IResultSetTableFactory,9,5,0,0,14,INTERFACE
,/:org.dbunit.database.DatabaseTableMetaData,228,21,0,24,273,CLASS
,/:org.dbunit.database.DatabaseTableMetaData$PrimaryKeyData,24,0,0,0,24,INNER_CLASS
,/:org.dbunit.database.DatabaseConfig,288,15,0,81,384,CLASS
,/:org.dbunit.database.DatabaseConfig$ConfigProperty,61,0,0,0,61,INNER_CLASS
,/:org.dbunit.database.DatabaseConfig$Configurator,20,0,0,0,20,INNER_CLASS
,/:org.dbunit.database.CyclicTablesDependencyException,14,3,0,0,17,CLASS
,/:org.dbunit.database.CachedResultSetTable,28,6,0,0,34,CLASS
,/:org.dbunit.database.QueryDataSet,45,10,0,18,73,CLASS
,/:org.dbunit.database.QueryDataSet$TableEntry,18,0,0,0,18,INNER_CLASS
,/:org.dbunit.database.IResultSetTable,4,3,0,0,7,INTERFACE
,/:org.dbunit.database.IMetadataHandler,16,4,0,0,20,INTERFACE
,/:org.dbunit.database.DatabaseDataSourceConnection,88,8,0,0,96,CLASS
,/:org.dbunit.database.AbstractDatabaseConnection,107,15,0,0,122,CLASS
,/:org.dbunit.database.PrimaryKeyFilteredTableWrapper,56,10,0,0,66,CLASS
,/:org.dbunit.database.DatabaseDataSet,186,21,0,18,225,CLASS
,/:org.dbunit.database.DatabaseDataSet$OracleRecycleBinTableFilter,18,0,0,0,18,INNER_CLASS
,/:org.dbunit.database.QueryTableIterator,81,10,0,0,91,CLASS
,/:org.dbunit.database.search.ImportedKeysSearchCallback,11,6,0,0,17,CLASS
,/:org.dbunit.database.search.ImportedKeysSearchCallbackFilteredByPKs,25,10,0,0,35,CLASS
,/:org.dbunit.database.search.ForeignKeyRelationshipEdge,47,2,0,0,49,CLASS
,/:org.dbunit.database.search.ImportedAndExportedKeysSearchCallback,13,6,0,0,19,CLASS
,/:org.dbunit.database.search.ExportedKeysSearchCallback,11,6,0,0,17,CLASS
,/:org.dbunit.database.search.AbstractMetaDataBasedSearchCallback,132,18,0,0,150,CLASS
,/:org.dbunit.database.search.FKRelationshipEdge,18,2,0,0,20,CLASS
,/:org.dbunit.database.search.TablesDependencyHelper,116,15,0,0,131,CLASS
,/:org.dbunit.database.search.ImportedAndExportedKeysSearchCallbackFilteredByPKs,30,10,0,0,40,CLASS
,/:org.dbunit.database.ScrollableResultSetTable,83,8,0,0,91,CLASS
,/:org.dbunit.PropertiesBasedJdbcDatabaseTester,17,1,0,0,18,CLASS
,/:org.dbunit.AbstractDatabaseTester,117,8,0,11,136,CLASS
,/:org.dbunit.AbstractDatabaseTester$OperationType,11,0,0,0,11,INNER_CLASS
,/:org.dbunit.ext.hsqldb.HsqldbDataTypeFactory,19,8,0,0,27,CLASS
,/:org.dbunit.ext.hsqldb.HsqldbConnection,9,5,0,0,14,CLASS
,/:org.dbunit.ext.mysql.MySqlMetadataHandler,79,8,0,0,87,CLASS
,/:org.dbunit.ext.mysql.MySqlConnection,11,5,0,0,16,CLASS
,/:org.dbunit.ext.mysql.MySqlDataTypeFactory,40,9,0,0,49,CLASS
,/:org.dbunit.ext.postgresql.PostgresqlDataTypeFactory,34,9,0,0,43,CLASS
,/:org.dbunit.ext.postgresql.UuidType,41,13,0,0,54,CLASS
,/:org.dbunit.ext.postgresql.GenericEnumType,53,13,0,0,66,CLASS
,/:org.dbunit.ext.postgresql.IntervalType,36,12,0,0,48,CLASS
,/:org.dbunit.ext.postgresql.InetType,41,13,0,0,54,CLASS
,/:org.dbunit.ext.mssql.MsSqlDataTypeFactory,25,8,0,0,33,CLASS
,/:org.dbunit.ext.mssql.MsSqlConnection,30,13,0,0,43,CLASS
,/:org.dbunit.ext.mssql.InsertIdentityOperation,121,21,0,0,142,CLASS
,/:org.dbunit.ext.netezza.NetezzaMetadataHandler,74,8,0,0,82,CLASS
,/:org.dbunit.ext.netezza.NetezzaDataTypeFactory,77,6,0,0,83,CLASS
,/:org.dbunit.ext.db2.Db2DataTypeFactory,36,10,0,0,46,CLASS
,/:org.dbunit.ext.db2.Db2MetadataHandler,51,8,0,0,59,CLASS
,/:org.dbunit.ext.db2.Db2Connection,11,5,0,0,16,CLASS
,/:org.dbunit.ext.oracle.OracleSdoOrdinateArray,108,10,0,0,118,CLASS
,/:org.dbunit.ext.oracle.OracleSdoPointType,97,9,0,0,106,CLASS
,/:org.dbunit.ext.oracle.OracleSdoGeometry,121,9,0,0,130,CLASS
,/:org.dbunit.ext.oracle.OracleConnection,9,5,0,0,14,CLASS
,/:org.dbunit.ext.oracle.OracleClobDataType,61,11,0,0,72,CLASS
,/:org.dbunit.ext.oracle.OracleDataTypeFactory,79,11,0,0,90,CLASS
,/:org.dbunit.ext.oracle.OracleXMLTypeDataType,21,10,0,0,31,CLASS
,/:org.dbunit.ext.oracle.Oracle10DataTypeFactory,20,8,0,0,28,CLASS
,/:org.dbunit.ext.oracle.OracleSdoElemInfoArray,108,10,0,0,118,CLASS
,/:org.dbunit.ext.oracle.OracleBlobDataType,60,12,0,0,72,CLASS
,/:org.dbunit.ext.oracle.OracleNClobDataType,13,7,0,0,20,CLASS
,/:org.dbunit.ext.oracle.OracleSdoHelper,43,2,0,0,45,CLASS
,/:org.dbunit.ext.oracle.OracleSdoGeometryDataType,216,17,0,0,233,CLASS
,/:org.dbunit.ext.mckoi.MckoiConnection,9,5,0,0,14,CLASS
,/:org.dbunit.ext.mckoi.MckoiDataTypeFactory,43,9,0,0,52,CLASS
,/:org.dbunit.ext.h2.H2Connection,9,5,0,0,14,CLASS
,/:org.dbunit.ext.h2.H2DataTypeFactory,19,14,0,0,33,CLASS
,/:org.dbunit.PrepAndExpectedTestCase,12,2,0,0,14,INTERFACE
,/:org.dbunit.DataSourceBasedDBTestCase,17,4,0,0,21,CLASS
,/:org.dbunit.IOperationListener,18,5,0,0,23,INTERFACE
,/:org.dbunit.DefaultDatabaseTester,9,2,0,0,11,CLASS
,/:org.dbunit.operation.CloseConnectionOperation,22,7,0,0,29,CLASS
,/:org.dbunit.operation.DeleteOperation,43,12,0,0,55,CLASS
,/:org.dbunit.operation.CompositeOperation,31,8,0,0,39,CLASS
,/:org.dbunit.operation.TruncateTableOperation,27,8,0,0,35,CLASS
,/:org.dbunit.operation.DeleteAllOperation,59,15,0,0,74,CLASS
,/:org.dbunit.operation.AbstractOperation,35,14,0,0,49,CLASS
,/:org.dbunit.operation.UpdateOperation,59,12,0,0,71,CLASS
,/:org.dbunit.operation.RefreshOperation,64,20,0,143,227,CLASS
,/:org.dbunit.operation.RefreshOperation$RowOperation,33,0,0,0,33,INNER_CLASS
,/:org.dbunit.operation.RefreshOperation$InsertRowOperation,32,0,0,0,32,INNER_CLASS
,/:org.dbunit.operation.RefreshOperation$UpdateRowOperation,13,0,0,0,13,INNER_CLASS
,/:org.dbunit.operation.RefreshOperation$RowExistOperation,65,0,0,0,65,INNER_CLASS
,/:org.dbunit.operation.OperationData,27,3,0,0,30,CLASS
,/:org.dbunit.operation.ExclusiveTransactionException,19,2,0,0,21,CLASS
,/:org.dbunit.operation.AbstractBatchOperation,122,18,0,0,140,CLASS
,/:org.dbunit.operation.DatabaseOperation,20,5,0,6,31,CLASS
,/:org.dbunit.operation.DatabaseOperation$DummyOperation,6,0,0,0,6,INNER_CLASS
,/:org.dbunit.operation.TransactionOperation,45,8,0,0,53,CLASS
,/:org.dbunit.operation.InsertOperation,83,9,0,0,92,CLASS
,/:org.dbunit.DatabaseUnitException,24,1,0,0,25,CLASS
,/:org.dbunit.JdbcBasedDBTestCase,32,3,0,0,35,CLASS
,/:org.dbunit.VerifyTableDefinition,46,2,0,0,48,CLASS
,/:org.dbunit.DBTestCase,20,4,0,0,24,CLASS
,/:org.dbunit.JndiDatabaseTester,59,10,0,0,69,CLASS
,/:org.dbunit.JdbcDatabaseTester,55,7,0,0,62,CLASS
,/:org.dbunit.ant.Table,24,3,0,0,27,CLASS
,/:org.dbunit.ant.DbUnitTaskStep,5,3,0,0,8,INTERFACE
,/:org.dbunit.ant.DbConfig,42,11,0,17,70,CLASS
,/:org.dbunit.ant.DbConfig$Feature,17,0,0,0,17,INNER_CLASS
,/:org.dbunit.ant.Compare,107,15,0,0,122,CLASS
,/:org.dbunit.ant.Export,166,23,0,0,189,CLASS
,/:org.dbunit.ant.Query,35,3,0,0,38,CLASS
,/:org.dbunit.ant.AbstractStep,170,31,0,0,201,CLASS
,/:org.dbunit.ant.DbUnitTask,327,22,0,0,349,CLASS
,/:org.dbunit.ant.QuerySet,78,13,0,0,91,CLASS
,/:org.dbunit.ant.Operation,143,14,0,0,157,CLASS
,/:org.dbunit.Assertion,53,8,0,0,61,CLASS
,/:org.dbunit.JndiBasedDBTestCase,21,4,0,0,25,CLASS
,/:org.dbunit.IDatabaseTester,13,4,0,0,17,INTERFACE
,/:org.dbunit.DefaultPrepAndExpectedTestCase,223,13,0,0,236,CLASS
,/:org.dbunit.util.QualifiedTableName,124,5,0,0,129,CLASS
,/:org.dbunit.util.CollectionsHelper,34,5,0,0,39,CLASS
,/:org.dbunit.util.Base64,350,4,0,183,537,CLASS
,/:org.dbunit.util.Base64$InputStream,104,0,0,0,104,INNER_CLASS
,/:org.dbunit.util.Base64$OutputStream,79,0,0,0,79,INNER_CLASS
,/:org.dbunit.util.SQLHelper,373,16,0,17,406,CLASS
,/:org.dbunit.util.SQLHelper$ExceptionWrapper,17,0,0,0,17,INNER_CLASS
,/:org.dbunit.util.TableFormatter,82,5,0,0,87,CLASS
,/:org.dbunit.util.fileloader.CsvDataFileLoader,15,7,0,0,22,CLASS
,/:org.dbunit.util.fileloader.XlsDataFileLoader,16,8,0,0,24,CLASS
,/:org.dbunit.util.fileloader.FullXmlDataFileLoader,16,8,0,0,24,CLASS
,/:org.dbunit.util.fileloader.DataFileLoader,7,4,0,0,11,INTERFACE
,/:org.dbunit.util.fileloader.AbstractDataFileLoader,77,12,0,0,89,CLASS
,/:org.dbunit.util.fileloader.FlatXmlDataFileLoader,29,7,0,0,36,CLASS
,/:org.dbunit.util.FileHelper,76,15,0,0,91,CLASS
,/:org.dbunit.util.xml.XmlWriter,475,9,0,0,484,CLASS
,/:org.dbunit.util.search.IEdge,4,1,0,0,5,INTERFACE
,/:org.dbunit.util.search.ISearchCallback,5,2,0,0,7,INTERFACE
,/:org.dbunit.util.search.DepthFirstSearch,144,9,0,0,153,CLASS
,/:org.dbunit.util.search.AbstractNodesFilterSearchCallback,61,5,0,0,66,CLASS
,/:org.dbunit.util.search.AbstractIncludeNodesSearchCallback,11,2,0,0,13,CLASS
,/:org.dbunit.util.search.Edge,61,3,0,0,64,CLASS
,/:org.dbunit.util.search.AbstractExcludeNodesSearchCallback,11,2,0,0,13,CLASS
,/:org.dbunit.util.search.SearchException,14,2,0,0,16,CLASS
,/:org.dbunit.util.search.ISearchAlgorithm,3,3,0,0,6,INTERFACE
,/:org.dbunit.util.concurrent.Sync,12,1,0,0,13,INTERFACE
,/:org.dbunit.util.concurrent.BoundedChannel,3,1,0,0,4,INTERFACE
,/:org.dbunit.util.concurrent.Semaphore,67,3,0,0,70,CLASS
,/:org.dbunit.util.concurrent.DefaultChannelCapacity,14,3,0,0,17,CLASS
,/:org.dbunit.util.concurrent.LinkedQueue,126,3,0,0,129,CLASS
,/:org.dbunit.util.concurrent.LinkedNode,7,1,0,0,8,CLASS
,/:org.dbunit.util.concurrent.TimeoutException,10,1,0,0,11,CLASS
,/:org.dbunit.util.concurrent.Channel,7,1,0,0,8,INTERFACE
,/:org.dbunit.util.concurrent.Executor,3,1,0,0,4,INTERFACE
,/:org.dbunit.util.concurrent.SynchronousChannel,237,3,0,19,259,CLASS
,/:org.dbunit.util.concurrent.SynchronousChannel$Queue,19,0,0,0,19,INNER_CLASS
,/:org.dbunit.util.concurrent.Takable,4,1,0,0,5,INTERFACE
,/:org.dbunit.util.concurrent.SynchronizedVariable,16,3,0,0,19,CLASS
,/:org.dbunit.util.concurrent.BoundedLinkedQueue,213,3,0,0,216,CLASS
,/:org.dbunit.util.concurrent.SemaphoreControlledChannel,100,5,0,0,105,CLASS
,/:org.dbunit.util.concurrent.Puttable,4,1,0,0,5,INTERFACE
,/:org.dbunit.util.concurrent.BoundedBuffer,131,3,0,0,134,CLASS
,/:org.dbunit.util.concurrent.Slot,27,4,0,0,31,CLASS
,/:org.dbunit.util.concurrent.SynchronizedInt,133,3,0,0,136,CLASS
,/:org.dbunit.util.concurrent.PropertyChangeMulticaster,195,10,0,0,205,CLASS
,/:org.dbunit.DefaultOperationListener,23,5,0,0,28,CLASS
,/:org.dbunit.DatabaseUnitRuntimeException,24,1,0,0,25,CLASS
,/:org.dbunit.DatabaseTestCase,84,8,0,0,92,CLASS
,/:org.dbunit.dataset.CompositeTable,64,4,0,0,68,CLASS
,/:org.dbunit.dataset.AbstractDataSet,88,3,0,0,91,CLASS
,/:org.dbunit.dataset.ITableIterator,6,1,0,0,7,INTERFACE
,/:org.dbunit.dataset.FilteredDataSet,46,6,0,0,52,CLASS
,/:org.dbunit.dataset.FilteredTableMetaData,49,6,0,0,55,CLASS
,/:org.dbunit.dataset.CompositeDataSet,93,4,0,0,97,CLASS
,/:org.dbunit.dataset.ReplacementDataSet,82,5,0,24,111,CLASS
,/:org.dbunit.dataset.ReplacementDataSet$ReplacementIterator,24,0,0,0,24,INNER_CLASS
,/:org.dbunit.dataset.CachedDataSet,80,5,0,0,85,CLASS
,/:org.dbunit.dataset.NoPrimaryKeyException,18,1,0,0,19,CLASS
,/:org.dbunit.dataset.DefaultTableMetaData,42,2,0,0,44,CLASS
,/:org.dbunit.dataset.ForwardOnlyDataSet,36,3,0,21,60,CLASS
,/:org.dbunit.dataset.ForwardOnlyDataSet$ForwardOnlyIterator,21,0,0,0,21,INNER_CLASS
,/:org.dbunit.dataset.OrderedTableNameMap,131,11,0,0,142,CLASS
,/:org.dbunit.dataset.SortedTable,115,8,0,77,200,CLASS
,/:org.dbunit.dataset.SortedTable$AbstractRowComparator,40,0,0,0,40,INNER_CLASS
,/:org.dbunit.dataset.SortedTable$RowComparator,18,0,0,0,18,INNER_CLASS
,/:org.dbunit.dataset.SortedTable$RowComparatorByString,19,0,0,0,19,INNER_CLASS
,/:org.dbunit.dataset.RowFilterTable,55,6,0,0,61,CLASS
,/:org.dbunit.dataset.excel.XlsDataSet,35,16,0,0,51,CLASS
,/:org.dbunit.dataset.excel.XlsDataSetWriter,98,21,0,0,119,CLASS
,/:org.dbunit.dataset.excel.XlsTable,183,22,0,0,205,CLASS
,/:org.dbunit.dataset.AbstractTable,35,3,0,0,38,CLASS
,/:org.dbunit.dataset.common.handlers.EnforceHandler,52,3,0,16,71,CLASS
,/:org.dbunit.dataset.common.handlers.EnforceHandler$ENFORCE,16,0,0,0,16,INNER_CLASS
,/:org.dbunit.dataset.common.handlers.AbstractPipelineComponent,67,3,0,11,81,CLASS
,/:org.dbunit.dataset.common.handlers.AbstractPipelineComponent$IGNORE,4,0,0,0,4,INNER_CLASS
,/:org.dbunit.dataset.common.handlers.AbstractPipelineComponent$ACCEPT,7,0,0,0,7,INNER_CLASS
,/:org.dbunit.dataset.common.handlers.UnquotedFieldAssembler,19,4,0,8,31,CLASS
,/:org.dbunit.dataset.common.handlers.UnquotedFieldAssembler$ASSEMBLE,8,0,0,0,8,INNER_CLASS
,/:org.dbunit.dataset.common.handlers.WhitespacesHandler,17,3,0,0,20,CLASS
,/:org.dbunit.dataset.common.handlers.LineEndHandler,4,1,0,0,5,CLASS
,/:org.dbunit.dataset.common.handlers.IsAlnumHandler,29,3,0,26,58,CLASS
,/:org.dbunit.dataset.common.handlers.IsAlnumHandler$QUOTE,11,0,0,0,11,INNER_CLASS
,/:org.dbunit.dataset.common.handlers.IsAlnumHandler$UNQUOTE,15,0,0,0,15,INNER_CLASS
,/:org.dbunit.dataset.common.handlers.Handler,6,1,0,0,7,INTERFACE
,/:org.dbunit.dataset.common.handlers.EscapeHandler,27,3,0,12,42,CLASS
,/:org.dbunit.dataset.common.handlers.EscapeHandler$ESCAPE,12,0,0,0,12,INNER_CLASS
,/:org.dbunit.dataset.common.handlers.PipelineException,5,2,0,0,7,CLASS
,/:org.dbunit.dataset.common.handlers.QuoteHandler,30,3,0,32,65,CLASS
,/:org.dbunit.dataset.common.handlers.QuoteHandler$QUOTE,12,0,0,0,12,INNER_CLASS
,/:org.dbunit.dataset.common.handlers.QuoteHandler$UNQUOTE,20,0,0,0,20,INNER_CLASS
,/:org.dbunit.dataset.common.handlers.Pipeline,114,6,0,0,120,CLASS
,/:org.dbunit.dataset.common.handlers.NoHandler,9,1,0,0,10,CLASS
,/:org.dbunit.dataset.common.handlers.Helper,15,3,0,0,18,CLASS
,/:org.dbunit.dataset.common.handlers.PipelineComponent,6,1,0,0,7,INTERFACE
,/:org.dbunit.dataset.common.handlers.PipelineConfig,19,1,0,0,20,CLASS
,/:org.dbunit.dataset.common.handlers.SeparatorHandler,28,3,0,8,39,CLASS
,/:org.dbunit.dataset.common.handlers.SeparatorHandler$ENDPIECE,8,0,0,0,8,INNER_CLASS
,/:org.dbunit.dataset.common.handlers.IllegalInputCharacterException,6,2,0,0,8,CLASS
,/:org.dbunit.dataset.common.handlers.TransparentHandler,13,3,0,0,16,CLASS
,/:org.dbunit.dataset.common.handlers.AllHandler,15,3,0,0,18,CLASS
,/:org.dbunit.dataset.sqlloader.SqlLoaderControlParserImpl,207,27,0,0,234,CLASS
,/:org.dbunit.dataset.sqlloader.SqlLoaderControlDataSet,17,6,0,0,23,CLASS
,/:org.dbunit.dataset.sqlloader.SqlLoaderControlProducer,107,19,0,0,126,CLASS
,/:org.dbunit.dataset.sqlloader.SqlLoaderControlParserException,5,2,0,0,7,CLASS
,/:org.dbunit.dataset.sqlloader.SqlLoaderControlParser,6,7,0,0,13,INTERFACE
,/:org.dbunit.dataset.ForwardOnlyTable,29,3,0,0,32,CLASS
,/:org.dbunit.dataset.CachedTable,12,1,0,0,13,CLASS
,/:org.dbunit.dataset.ITableMetaData,7,1,0,0,8,INTERFACE
,/:org.dbunit.dataset.DefaultTable,105,5,0,0,110,CLASS
,/:org.dbunit.dataset.csv.IllegalCharacterSeen,5,1,0,0,6,CLASS
,/:org.dbunit.dataset.csv.CsvParser,5,7,0,0,12,INTERFACE
,/:org.dbunit.dataset.csv.CsvProducer,93,22,0,0,115,CLASS
,/:org.dbunit.dataset.csv.CsvDataSet,6,4,0,0,10,CLASS
,/:org.dbunit.dataset.csv.CsvDataSetWriter,163,20,0,0,183,CLASS
,/:org.dbunit.dataset.csv.CsvURLDataSet,6,4,0,0,10,CLASS
,/:org.dbunit.dataset.csv.CsvParserException,5,2,0,0,7,CLASS
,/:org.dbunit.dataset.csv.CsvURLProducer,65,15,0,0,80,CLASS
,/:org.dbunit.dataset.csv.CsvParserImpl,120,24,0,0,144,CLASS
,/:org.dbunit.dataset.stream.StreamingIterator,78,13,0,136,227,CLASS
,/:org.dbunit.dataset.stream.StreamingIterator$StreamingTable,64,0,0,0,64,INNER_CLASS
,/:org.dbunit.dataset.stream.StreamingIterator$AsynchronousConsumer,72,0,0,0,72,INNER_CLASS
,/:org.dbunit.dataset.stream.BufferedConsumer,69,10,0,22,101,CLASS
,/:org.dbunit.dataset.stream.BufferedConsumer$TableBuffer,22,0,0,0,22,INNER_CLASS
,/:org.dbunit.dataset.stream.IDataSetConsumer,8,3,0,0,11,INTERFACE
,/:org.dbunit.dataset.stream.DefaultConsumer,18,3,0,0,21,CLASS
,/:org.dbunit.dataset.stream.DataSetProducerAdapter,55,10,0,0,65,CLASS
,/:org.dbunit.dataset.stream.StreamingDataSet,41,8,0,0,49,CLASS
,/:org.dbunit.dataset.stream.IDataSetProducer,5,2,0,0,7,INTERFACE
,/:org.dbunit.dataset.CaseInsensitiveDataSet,52,4,0,20,76,CLASS
,/:org.dbunit.dataset.CaseInsensitiveDataSet$CaseInsensitiveIterator,20,0,0,0,20,INNER_CLASS
,/:org.dbunit.dataset.ReplacementTable,170,6,0,0,176,CLASS
,/:org.dbunit.dataset.DefaultDataSet,56,4,0,0,60,CLASS
,/:org.dbunit.dataset.RowOutOfBoundsException,18,1,0,0,19,CLASS
,/:org.dbunit.dataset.IDataSet,11,1,0,0,12,INTERFACE
,/:org.dbunit.dataset.ColumnFilterTable,42,4,0,0,46,CLASS
,/:org.dbunit.dataset.DefaultTableIterator,38,3,0,0,41,CLASS
,/:org.dbunit.dataset.filter.DefaultTableFilter,25,4,0,0,29,CLASS
,/:org.dbunit.dataset.filter.IColumnFilter,4,2,0,0,6,INTERFACE
,/:org.dbunit.dataset.filter.IRowFilter,3,2,0,0,5,INTERFACE
,/:org.dbunit.dataset.filter.ExcludeTableFilter,31,4,0,0,35,CLASS
,/:org.dbunit.dataset.filter.ITableFilterSimple,4,2,0,0,6,INTERFACE
,/:org.dbunit.dataset.filter.IncludeTableFilter,31,3,0,0,34,CLASS
,/:org.dbunit.dataset.filter.SequenceTableFilter,60,13,0,0,73,CLASS
,/:org.dbunit.dataset.filter.ITableFilter,6,4,0,0,10,INTERFACE
,/:org.dbunit.dataset.filter.SequenceTableIterator,28,8,0,0,36,CLASS
,/:org.dbunit.dataset.filter.DefaultColumnFilter,91,7,0,0,98,CLASS
,/:org.dbunit.dataset.filter.AbstractTableFilter,32,10,0,31,73,CLASS
,/:org.dbunit.dataset.filter.AbstractTableFilter$FilterIterator,31,0,0,0,31,INNER_CLASS
,/:org.dbunit.dataset.filter.PatternMatcher,218,6,0,0,224,CLASS
,/:org.dbunit.dataset.IRowValueProvider,3,1,0,0,4,INTERFACE
,/:org.dbunit.dataset.DataSetUtils,129,10,0,0,139,CLASS
,/:org.dbunit.dataset.SortedDataSet,31,3,0,20,54,CLASS
,/:org.dbunit.dataset.SortedDataSet$SortedIterator,20,0,0,0,20,INNER_CLASS
,/:org.dbunit.dataset.AbstractTableMetaData,108,16,0,0,124,CLASS
,/:org.dbunit.dataset.datatype.IDbProductRelatable,4,2,0,0,6,INTERFACE
,/:org.dbunit.dataset.datatype.BitDataType,7,2,0,0,9,CLASS
,/:org.dbunit.dataset.datatype.StringDataType,100,10,0,0,110,CLASS
,/:org.dbunit.dataset.datatype.BooleanDataType,88,8,0,0,96,CLASS
,/:org.dbunit.dataset.datatype.BlobDataType,28,8,0,0,36,CLASS
,/:org.dbunit.dataset.datatype.ClobDataType,26,8,0,0,34,CLASS
,/:org.dbunit.dataset.datatype.AbstractDataType,119,7,0,0,126,CLASS
,/:org.dbunit.dataset.datatype.TimestampDataType,84,13,0,0,97,CLASS
,/:org.dbunit.dataset.datatype.NumberTolerantDataType,77,5,0,0,82,CLASS
,/:org.dbunit.dataset.datatype.TimeDataType,67,9,0,0,76,CLASS
,/:org.dbunit.dataset.datatype.BytesDataType,188,18,0,0,206,CLASS
,/:org.dbunit.dataset.datatype.BinaryStreamDataType,53,10,0,0,63,CLASS
,/:org.dbunit.dataset.datatype.IntegerDataType,53,8,0,0,61,CLASS
,/:org.dbunit.dataset.datatype.IDataTypeFactory,6,1,0,0,7,INTERFACE
,/:org.dbunit.dataset.datatype.DateDataType,79,8,0,0,87,CLASS
,/:org.dbunit.dataset.datatype.DataTypeException,19,2,0,0,21,CLASS
,/:org.dbunit.dataset.datatype.NumberDataType,54,8,0,0,62,CLASS
,/:org.dbunit.dataset.datatype.UnknownDataType,26,5,0,0,31,CLASS
,/:org.dbunit.dataset.datatype.BigIntegerDataType,59,10,0,0,69,CLASS
,/:org.dbunit.dataset.datatype.StringIgnoreCaseDataType,15,3,0,0,18,CLASS
,/:org.dbunit.dataset.datatype.DefaultDataTypeFactory,67,7,0,0,74,CLASS
,/:org.dbunit.dataset.datatype.DoubleDataType,48,8,0,0,56,CLASS
,/:org.dbunit.dataset.datatype.ToleratedDeltaMap,50,7,0,71,128,CLASS
,/:org.dbunit.dataset.datatype.ToleratedDeltaMap$ToleratedDelta,48,0,0,0,48,INNER_CLASS
,/:org.dbunit.dataset.datatype.ToleratedDeltaMap$Precision,23,0,0,0,23,INNER_CLASS
,/:org.dbunit.dataset.datatype.DataType,111,7,0,0,118,CLASS
,/:org.dbunit.dataset.datatype.LongDataType,48,9,0,0,57,CLASS
,/:org.dbunit.dataset.datatype.FloatDataType,48,9,0,0,57,CLASS
,/:org.dbunit.dataset.datatype.TypeCastException,25,1,0,0,26,CLASS
,/:org.dbunit.dataset.ITable,7,1,0,0,8,INTERFACE
,/:org.dbunit.dataset.xml.FlatDtdWriter,59,8,0,73,140,CLASS
,/:org.dbunit.dataset.xml.FlatDtdWriter$ContentModel,14,0,0,0,14,INNER_CLASS
,/:org.dbunit.dataset.xml.FlatDtdWriter$SequenceModel,24,0,0,0,24,INNER_CLASS
,/:org.dbunit.dataset.xml.FlatDtdWriter$ChoiceModel,35,0,0,0,35,INNER_CLASS
,/:org.dbunit.dataset.xml.XmlDataSetWriter,198,17,0,0,215,CLASS
,/:org.dbunit.dataset.xml.XmlProducer,240,26,0,0,266,CLASS
,/:org.dbunit.dataset.xml.FlatXmlDataSet,129,14,0,0,143,CLASS
,/:org.dbunit.dataset.xml.FlatXmlDataSetBuilder,116,12,0,0,128,CLASS
,/:org.dbunit.dataset.xml.FlatDtdProducer,223,29,0,0,252,CLASS
,/:org.dbunit.dataset.xml.FlatXmlProducer,295,30,0,33,358,CLASS
,/:org.dbunit.dataset.xml.FlatXmlProducer$FlatDtdHandler,33,0,0,0,33,INNER_CLASS
,/:org.dbunit.dataset.xml.FlatDtdDataSet,131,22,0,0,153,CLASS
,/:org.dbunit.dataset.xml.XmlDataSet,41,12,0,0,53,CLASS
,/:org.dbunit.dataset.xml.FlatXmlWriter,136,16,0,0,152,CLASS
,/:org.dbunit.dataset.LowerCaseDataSet,50,3,0,20,73,CLASS
,/:org.dbunit.dataset.LowerCaseDataSet$LowerCaseIterator,20,0,0,0,20,INNER_CLASS
,/:org.dbunit.dataset.CaseInsensitiveTable,38,3,0,0,41,CLASS
,/:org.dbunit.dataset.Column,128,5,0,50,183,CLASS
,/:org.dbunit.dataset.Column$Nullable,12,0,0,0,12,INNER_CLASS
,/:org.dbunit.dataset.Column$AutoIncrement,38,0,0,0,38,INNER_CLASS
,/:org.dbunit.dataset.DataSetException,18,2,0,0,20,CLASS
,/:org.dbunit.dataset.NoSuchColumnException,37,1,0,0,38,CLASS
,/:org.dbunit.dataset.LowerCaseTableMetaData,60,3,0,0,63,CLASS
,/:org.dbunit.dataset.NoSuchTableException,18,1,0,0,19,CLASS
,/:org.dbunit.dataset.Columns,151,8,0,107,266,CLASS
,/:org.dbunit.dataset.Columns$ColumnComparator,13,0,0,0,13,INNER_CLASS
,/:org.dbunit.dataset.Columns$ColumnDiff,94,0,0,0,94,INNER_CLASS
,/:org.dbunit.assertion.DbAssertionFailedError,8,1,0,0,9,CLASS
,/:org.dbunit.assertion.DifferenceListener,4,1,0,0,5,INTERFACE
,/:org.dbunit.assertion.DbComparisonFailure,48,1,0,0,49,CLASS
,/:org.dbunit.assertion.FailureHandler,5,2,0,0,7,INTERFACE
,/:org.dbunit.assertion.DbUnitAssert,274,17,0,44,335,CLASS
,/:org.dbunit.assertion.DbUnitAssert$ComparisonColumn,44,0,0,0,44,INNER_CLASS
,/:org.dbunit.assertion.DefaultFailureHandler,133,11,0,11,155,CLASS
,/:org.dbunit.assertion.DefaultFailureHandler$DefaultFailureFactory,11,0,0,0,11,INNER_CLASS
,/:org.dbunit.assertion.JUnitFailureFactory,11,3,0,0,14,CLASS
,/:org.dbunit.assertion.SimpleAssert,37,3,0,0,40,CLASS
,/:org.dbunit.assertion.FailureFactory,5,1,0,0,6,INTERFACE
,/:org.dbunit.assertion.DiffCollectingFailureHandler,21,3,0,0,24,CLASS
,/:org.dbunit.assertion.Difference,52,2,0,0,54,CLASS
,/:org.dbunit.DataSourceDatabaseTester,29,6,0,0,35,CLASS
Total,,20845,2278,0,1592,24715